2222222111111112211212121221212122222222
2000002000000000000000000000000000000002
2000002000000000000000000000000000100001
2000000000002222111212000000000001100211
2000002000002020200221110000101001010001
2000001000000000000000000000011122121201
2000002000000000121210000000001111000001
1111111111111111111111111111111111111111
