131313131313133131131313131313131313131313
300000000000000000000000000000000000000001
100000000000000000000000000000000000000001
300000000000000000000000000000000000000001
100000000000000000000000000000000000000001
300000000000000000000000000000000000000001
100000000000000000000000000000000000000001
300000000000000000000000000000000000000001
200000000000000000000000000000000000000001
100000000000000000000000000000000000000001
200000000000000000000000000000000000000001
300000000000000000000000000000000000000001
300000000000000000000000000000000000000001
100000000000000000000000000000000000000001
300000000000000000000000000000000000000001
100000000000000000000000000000000000000001
300000000000000000000000000000000000000001
100000000000000000000000000000000000000001
300000000000000000000000000000000000000001
100000000000000000000000000000000000000001
300000000000000000000000000000000000000001
100000000000000000000000000000000000000001
300000000000000000000000000000000000000001
100000000000000000000000000000000000000001
300000000000000000000000000000000000000001
100000000000000000000000000000000000000001
300000000000000000000000000000000000000001
100000000000000000000000000000000000000001
300000000000000000000000000000000000000001
100000000000000000000000000000000000000001
300000000000000000000000000000000000000001
100000000000000000000000000000000000000001
300000000000000000000000000000000000000001
100000000000000000000000000000000000000001
300000000000000000000000000000000000000001
131313131313133131131313131313131313131313
