111111111111111111111111111111111111111111111111111111111111111111111111111111
1           1                         1                        1             1
1   2    2  1            222222222    1      2                 1             1
1           5            2            1      2                 5             1
1           1            2            5      2222222222222     1             4
1   2    2  1    222222222            1                  2     1             1
1           1                         1                  2     1             1
1           1                         1                        1             1
111111111111111111111111111111111111111111111111111111111111111111111111111111
177777777777777777777777777777777777777777777777777777777777777777777777777771
17          7              7            8                                   71
17  8       7     8        7                        88888888                71
17      8   7              7               8        8     48                71
17          5              7       8         88     5     88                71
17   8      7      8       5                    8   88888888                71
17          7              7                                                71
177777777777777777777777777777777777777777777777777777777777777777777777777771
111111111111111111111111111111111111111111111111111111111111111111111111111111
