1111111
1  in 1
1  da 1
1  ih 1
1111111
